8193,8194,8194,8194,8194,8194,8194,8194,8194,8194,8194,8194,8194,8194,8194,8194,8194,8194,8194,8194,8194,8194,8194,8194,8194,8194,8194,8194,8194,8194,8194,8194,8194,8194
8193,3,2,2,2,5,0,0,6,2,2,2,2,2,2,2,2,2,2,2,2,2,2,2,2,2,2,2,2,2,2,2,4,8195
8193,1,16,16,16,16,0,0,16,16,16,16,16,16,16,16,16,16,16,16,16,16,16,16,16,16,16,16,16,16,16,16,1,8195
8193,1,0,0,0,0,0,0,0,0,0,0,0,0,0,0,0,0,0,0,0,0,0,0,0,0,0,0,0,0,0,0,1,8195
8193,1,0,0,0,0,0,0,0,0,0,0,0,0,0,0,0,0,0,0,0,0,0,0,0,0,0,0,0,0,0,0,1,8195
8193,1,0,0,0,0,0,0,0,0,0,0,0,0,0,0,0,0,0,0,0,0,0,0,0,0,0,0,0,0,0,0,1,8195
8193,1,0,0,0,3,2,2,2,2,2,2,2,2,2,2,2,2,2,2,2,2,2,2,2,2,2,2,4,0,0,0,1,8195
8193,1,0,0,0,1,8197,8197,8197,8197,8197,8197,8197,8197,8197,8197,8197,8197,8197,8197,8197,8197,8197,8197,8197,8197,8197,8197,10,0,0,0,1,8195
8193,1,0,0,0,1,8197,8197,8197,8197,8197,8197,8197,8197,8197,8197,8197,8197,8197,8197,8197,8197,8197,8197,8197,8197,8197,8197,16,0,0,0,1,8195
8193,1,0,0,0,1,8197,8197,8197,8197,8197,8197,8197,8197,8197,8197,8197,8197,8197,8197,8197,8197,8197,8197,8197,8197,8197,8197,0,0,0,0,1,8195
8193,1,0,0,0,1,8197,8197,8197,8197,8197,8197,8197,8197,8197,8197,8197,8197,8197,8197,8197,8197,8197,8197,8197,8197,8197,8197,0,0,0,0,1,8195
8193,1,0,0,0,1,8197,8197,8197,8197,8197,8197,8197,8197,8197,8197,8197,8197,8197,8197,8197,8197,8197,8197,8197,8197,8197,8197,8,0,0,0,1,8195
8193,1,0,0,0,1,8197,8197,8197,8197,8197,8197,8197,8197,8197,8197,8197,8197,8197,8197,8197,8197,8197,8197,8197,8197,8197,8197,15,0,0,0,1,8195
8193,1,0,0,0,1,8197,8197,8197,8197,8197,8197,8197,8197,8197,8197,8197,8197,8197,8197,8197,8197,8197,8197,8197,8197,8197,8197,1,0,0,0,1,8195
8193,1,0,0,0,1,8197,8197,8197,8197,8197,8197,8197,8197,8197,8197,8197,8197,8197,8197,8197,8197,8197,8197,8197,8197,8197,8197,1,0,0,0,1,8195
8193,1,0,0,0,1,8197,8197,8197,8197,8197,8197,8197,8197,8197,8197,8197,8197,8197,8197,8197,8197,8197,8197,8197,8197,8197,8197,1,0,0,0,1,8195
8193,1,0,0,0,1,8197,8197,8197,8197,8197,8197,8197,8197,8197,8197,8197,8197,8197,8197,8197,8197,8197,8197,8197,8197,8197,8197,1,0,0,0,6,8195
8193,5,0,0,0,1,8197,8197,8197,8197,8197,8197,8197,8197,8197,8197,8197,8197,8197,8197,8197,8197,8197,8197,8197,8197,8197,8197,1,0,0,0,16,8195
8193,16,0,0,0,1,8197,8197,8197,8197,8197,8197,8197,8197,8197,8197,8197,8197,8197,8197,8197,8197,8197,8197,8197,8197,8197,8197,1,0,0,0,0,8195
8193,0,0,0,0,1,8197,8197,8197,8197,8197,8197,8197,8197,8197,8197,8197,8197,8197,8197,8197,8197,8197,8197,8197,8197,8197,8197,1,0,0,0,0,8195
8193,0,0,0,0,1,8197,8197,8197,8197,8197,8197,8197,8197,8197,8197,8197,8197,8197,8197,8197,8197,8197,8197,8197,8197,8197,8197,1,0,0,0,3,8195
8193,4,0,0,0,1,8197,8197,8197,8197,8197,8197,8197,8197,8197,8197,8197,8197,8197,8197,8197,8197,8197,8197,8197,8197,8197,8197,1,0,0,0,1,8195
8193,1,0,0,0,1,8197,8197,8197,8197,8197,8197,8197,8197,8197,8197,8197,8197,8197,8197,8197,8197,8197,8197,8197,8197,8197,8197,1,0,0,0,1,8195
8193,1,0,0,0,1,8197,8197,8197,8197,8197,8197,8197,8197,8197,8197,8197,8197,8197,8197,8197,8197,8197,8197,8197,8197,8197,8197,1,0,0,0,1,8195
8193,1,0,0,0,1,8197,8197,8197,8197,8197,8197,8197,8197,8197,8197,8197,8197,8197,8197,8197,8197,8197,8197,8197,8197,8197,8197,1,0,0,0,1,8195
8193,1,0,0,0,1,8197,8197,8197,8197,8197,8197,8197,8197,8197,8197,8197,8197,8197,8197,8197,8197,8197,8197,8197,8197,8197,8197,1,0,0,0,1,8195
8193,1,0,0,0,1,8197,8197,8197,8197,8197,8197,8197,8197,8197,8197,8197,8197,8197,8197,8197,8197,8197,8197,8197,8197,8197,8197,1,0,0,0,1,8195
8193,1,0,0,0,6,2,9,0,0,7,14,2,2,2,2,2,2,2,2,2,2,2,2,2,2,2,2,5,0,0,0,1,8195
8193,1,0,0,0,16,16,16,0,0,16,16,16,16,16,16,16,16,16,16,16,16,16,16,16,16,16,16,16,0,0,0,1,8195
8193,1,0,0,0,0,0,0,0,0,0,0,0,0,0,0,0,0,0,0,0,0,0,0,0,0,0,0,0,0,0,0,1,8195
8193,1,0,0,0,0,0,0,0,0,0,0,0,0,0,0,0,0,0,0,0,0,0,0,0,0,0,0,0,0,0,0,1,8195
8193,1,0,0,0,0,0,0,0,0,0,0,0,0,0,0,0,0,0,0,0,0,0,0,0,0,0,0,0,0,0,0,1,8195
8193,6,2,2,2,2,2,2,2,2,2,2,2,4,0,0,3,2,2,2,2,2,2,2,2,2,2,2,2,2,2,2,5,8195
8196,8196,8196,8196,8196,8196,8196,8196,8196,8196,8196,8196,8196,8196,8196,8196,8196,8196,8196,8196,8196,8196,8196,8196,8196,8196,8196,8196,8196,8196,8196,8196,8196,8195














