8192,8192,8192,8192,8192,8192,8192,8192,8192,8192,8192,8192,8192,8192,8192,8192,8192,8192,8192,8192,8192,8192,8192,8192,8192,8192,8192,8192,8192,8192,8192,8192,8192,8192
8192,8192,8192,8192,8192,8192,8192,8192,8192,8192,8192,8192,8192,8192,8192,8192,8192,8192,8192,8192,8192,8192,8192,8192,8192,8192,8192,8192,8192,8192,8192,8192,8192,8192
8192,8192,8192,8192,8192,8192,8192,8192,8192,8192,8192,8192,8192,8192,8192,8192,8192,8192,8192,8192,8192,8192,8192,8192,8192,8192,8192,8192,8192,8192,8192,8192,8192,8192
8192,8192,8192,8192,8192,8192,8192,8192,8192,8192,8192,8192,8192,8192,8192,8192,8192,8192,8192,8192,8192,8192,8192,8192,8192,8192,8192,8192,8192,8192,8192,8192,8192,8192
8192,8192,8192,8192,8192,8192,8192,8192,8192,8192,8192,8192,8192,8192,8192,8192,8192,8192,8192,8192,8192,8192,8192,8192,8192,8192,8192,8192,8192,8192,8192,8192,8192,8192
8192,8192,8192,8192,8192,8192,8192,8192,8192,8192,8192,8192,8192,8192,8192,8192,8192,8192,8192,8192,8192,8192,8192,8192,8192,8192,8192,8192,8192,8192,8192,8192,8192,8192
8192,8192,8192,8192,8192,3,2,2,2,2,2,2,2,2,2,2,2,2,2,2,2,2,2,2,2,2,2,2,4,8192,8192,8192,8192,8192
8192,8192,8192,8192,8192,1,16,16,16,16,16,16,16,16,16,16,16,16,16,16,16,16,16,16,16,16,16,16,10,8192,8192,8192,8192,8192
8192,8192,8192,8192,8192,1,0,0,0,0,0,0,0,0,0,0,0,0,0,0,0,0,0,0,0,0,0,0,16,8192,8192,8192,8192,8192
8192,8192,8192,8192,8192,1,0,0,0,0,0,0,0,0,0,0,0,0,0,0,0,0,0,0,0,0,0,0,0,8192,8192,8192,8192,8192
8192,8192,8192,8192,8192,1,0,0,0,0,0,0,0,0,0,0,0,0,0,0,0,0,0,0,0,0,0,0,0,8192,8192,8192,8192,8192
8192,8192,8192,8192,8192,1,0,0,0,0,0,0,0,0,0,0,0,0,0,0,0,0,0,0,0,0,0,0,8,8192,8192,8192,8192,8192
8192,8192,8192,8192,8192,1,0,0,0,0,0,3,2,2,2,2,2,2,2,2,2,2,2,2,2,2,2,2,15,8192,8192,8192,8192,8192
8192,8192,8192,8192,8192,1,0,0,0,0,0,1,8198,8198,8198,8198,8198,8198,8198,8198,8198,8198,8198,8198,8198,8198,8198,8198,8198,8192,8192,8192,8192,8192
8192,8192,8192,8192,8192,1,0,0,0,0,0,1,8198,8198,8198,8198,8198,8198,8198,8198,8198,8198,8198,8198,8198,8198,8198,8198,8198,8192,8192,8192,8192,8192
8192,8192,8192,8192,8192,1,0,0,0,0,0,1,8198,8198,8198,8198,8198,8198,8198,8198,8198,8198,8198,8198,8198,8198,8198,8198,8198,8192,8192,8192,8192,8192
8192,8192,8192,8192,8192,1,0,0,0,0,0,1,8198,8198,8198,8198,8198,8198,8198,8198,8198,8198,8198,8198,8198,8198,8198,8198,8198,8192,8192,8192,8192,8192
8192,8192,8192,8192,8192,1,0,0,0,0,0,1,8198,8198,8198,8198,8198,8198,8198,8198,8198,8198,8198,8198,8198,8198,8198,8198,8198,8192,8192,8192,8192,8192
8192,8192,8192,8192,8192,1,0,0,0,0,0,1,8198,8198,8198,8198,8198,8198,8198,8198,8198,8198,8198,8198,8198,8198,8198,8198,8198,8192,8192,8192,8192,8192
8192,8192,8192,8192,8192,1,0,0,0,0,0,1,8198,8198,8198,8198,8198,8198,8198,8198,8198,8198,8198,8198,8198,8198,8198,8198,8198,8192,8192,8192,8192,8192
8192,8192,8192,8192,8192,1,0,0,0,0,0,1,8198,8198,8198,8198,8198,8198,8198,8198,8198,8198,8198,8198,8198,8198,8198,8198,8198,8192,8192,8192,8192,8192
8192,8192,8192,8192,8192,1,0,0,0,0,0,10,8198,8198,8198,8198,8198,8198,8198,8198,8198,8198,8198,8198,8198,8198,8198,8198,8198,8192,8192,8192,8192,8192
8192,8192,8192,8192,8192,1,0,0,0,0,0,16,8198,8198,8198,8198,8198,8198,8198,8198,8198,8198,8198,8198,8198,8198,8198,8198,8198,8192,8192,8192,8192,8192
8192,8192,8192,8192,8192,1,0,0,0,0,0,0,8198,8198,8198,8198,8198,8198,8198,8198,8198,8198,8198,8198,8198,8198,8198,8198,8198,8192,8192,8192,8192,8192
8192,8192,8192,8192,8192,1,0,0,0,0,0,0,8198,8198,8198,8198,8198,8198,8198,8198,8198,8198,8198,8198,8198,8198,8198,8198,8198,8192,8192,8192,8192,8192
8192,8192,8192,8192,8192,1,0,0,0,0,0,8,8198,8198,8198,8198,8198,8198,8198,8198,8198,8198,8198,8198,8198,8198,8198,8198,8198,8192,8192,8192,8192,8192
8192,8192,8192,8192,8192,1,0,0,0,0,0,1,8198,8198,8198,8198,8198,8198,8198,8198,8198,8198,8198,8198,8198,8198,8198,8198,8198,8192,8192,8192,8192,8192
8192,8192,8192,8192,8192,6,2,9,0,0,7,14,8198,8198,8198,8198,8198,8198,8198,8198,8198,8198,8198,8198,8198,8198,8198,8198,8198,8192,8192,8192,8192,8192
8192,8192,8192,8192,8192,8192,8192,8192,8192,8192,8192,8192,8192,8192,8192,8192,8192,8192,8192,8192,8192,8192,8192,8192,8192,8192,8192,8192,8192,8192,8192,8192,8192,8192
8192,8192,8192,8192,8192,8192,8192,8192,8192,8192,8192,8192,8192,8192,8192,8192,8192,8192,8192,8192,8192,8192,8192,8192,8192,8192,8192,8192,8192,8192,8192,8192,8192,8192
8192,8192,8192,8192,8192,8192,8192,8192,8192,8192,8192,8192,8192,8192,8192,8192,8192,8192,8192,8192,8192,8192,8192,8192,8192,8192,8192,8192,8192,8192,8192,8192,8192,8192
8192,8192,8192,8192,8192,8192,8192,8192,8192,8192,8192,8192,8192,8192,8192,8192,8192,8192,8192,8192,8192,8192,8192,8192,8192,8192,8192,8192,8192,8192,8192,8192,8192,8192
8192,8192,8192,8192,8192,8192,8192,8192,8192,8192,8192,8192,8192,8192,8192,8192,8192,8192,8192,8192,8192,8192,8192,8192,8192,8192,8192,8192,8192,8192,8192,8192,8192,8192
8192,8192,8192,8192,8192,8192,8192,8192,8192,8192,8192,8192,8192,8192,8192,8192,8192,8192,8192,8192,8192,8192,8192,8192,8192,8192,8192,8192,8192,8192,8192,8192,8192,8192
