17,17,17,17,17,17,17,17,17,17,17,17,17,17,17,17,17,17,17,17,17,17,17,17,17,17,17,17,17,17,17,17,17
17,3,2,2,2,2,2,2,2,2,2,2,2,2,2,12,2,2,2,2,2,2,2,2,2,2,2,2,2,2,2,2,4
17,1,16,16,16,16,16,16,16,16,16,16,16,16,16,1,16,16,16,16,16,16,16,16,16,16,16,16,16,16,16,16,1
17,1,0,0,0,0,0,0,0,0,0,0,0,0,0,1,0,0,0,0,0,0,0,0,0,0,0,0,0,0,0,0,1
17,1,0,0,0,0,0,0,0,0,0,0,0,0,0,1,0,0,0,0,0,0,0,0,0,0,0,0,0,0,0,0,1
17,1,0,0,0,0,0,0,0,0,0,0,0,0,0,1,0,0,0,0,0,0,0,0,0,0,0,0,0,0,0,0,1
17,1,0,0,0,0,0,0,0,0,0,0,0,0,0,1,0,0,0,0,0,0,3,2,2,2,2,2,2,4,0,0,1
17,1,0,0,0,0,0,0,0,0,0,0,0,0,0,1,0,0,0,0,0,0,1,16,16,16,16,16,16,1,0,0,1
17,1,0,0,0,0,0,0,0,0,0,0,0,0,0,1,0,0,0,0,0,0,1,0,0,0,0,0,0,1,0,0,1
17,1,0,0,0,0,0,0,0,0,0,0,0,0,0,1,0,0,0,0,0,0,1,0,0,0,0,0,0,1,0,0,1
17,1,0,0,0,0,0,0,0,0,0,0,0,0,0,10,0,0,0,0,0,0,1,0,0,7,2,2,2,5,0,0,1
17,1,0,0,0,0,0,0,0,0,0,0,0,0,0,16,0,0,0,0,0,0,1,0,0,16,16,16,16,16,0,0,1
17,1,0,0,0,0,0,0,0,0,0,0,0,0,0,0,0,0,0,0,0,0,1,0,0,0,0,0,0,0,0,0,1
17,1,0,0,0,0,0,0,0,0,0,0,0,0,0,0,0,0,0,0,0,0,1,0,0,0,0,0,0,0,0,0,1
17,1,0,0,0,0,0,0,0,0,0,0,0,0,0,0,0,7,2,2,2,2,14,2,2,2,2,9,0,0,0,0,1
17,1,0,0,0,0,0,0,0,0,0,0,0,0,0,0,0,16,16,16,16,16,16,16,16,16,16,16,0,0,0,0,1
17,1,0,0,0,0,0,0,0,0,0,7,2,2,9,0,0,0,0,0,0,0,0,0,0,0,0,0,0,0,0,0,1
17,10,0,0,0,0,0,0,0,0,0,16,16,16,16,0,0,0,0,0,0,0,0,0,0,0,0,0,0,0,0,0,1
17,16,0,0,0,0,0,0,0,0,0,0,0,0,0,0,0,7,2,2,2,2,12,2,2,2,9,0,0,0,0,0,1
17,0,0,0,0,0,0,0,0,0,0,0,0,0,0,0,0,16,16,16,16,16,1,16,16,16,16,0,0,0,0,0,1
17,0,0,0,0,0,0,0,0,0,0,0,0,0,0,0,0,0,0,0,0,0,1,0,0,0,0,0,0,0,0,0,1
17,8,0,0,0,0,0,0,0,0,0,0,0,0,0,0,0,0,0,0,0,0,1,0,0,0,0,0,0,0,0,0,1
17,1,0,0,0,0,0,0,0,0,0,0,0,0,0,0,0,0,0,0,0,0,13,2,2,2,2,2,2,9,0,0,1
17,1,0,0,0,0,0,0,0,0,0,0,0,0,0,0,0,0,0,0,0,0,1,16,16,16,16,16,16,16,0,0,1
17,1,0,0,0,0,0,0,7,2,2,2,12,2,2,2,9,0,0,0,0,0,1,0,0,0,0,0,0,0,0,0,1
17,1,0,0,0,0,0,0,16,16,16,16,1,16,16,16,16,0,0,0,0,0,1,0,0,0,0,0,0,0,0,0,1
17,1,0,0,0,0,0,0,0,0,0,0,1,0,0,0,0,0,0,0,7,2,14,2,9,0,0,0,0,0,0,0,1
17,1,0,0,0,0,0,0,0,0,0,0,1,0,0,0,0,0,0,0,16,16,16,16,16,0,0,0,0,0,0,0,1
17,1,0,0,0,0,0,0,0,0,0,0,10,0,0,0,0,0,0,0,0,0,0,0,0,0,0,0,0,0,0,0,1
17,1,0,0,0,0,0,0,0,0,0,0,16,0,0,0,0,0,0,0,0,0,0,0,0,0,0,0,0,0,0,0,1
17,1,0,0,0,0,0,0,0,0,0,0,0,0,0,0,0,0,0,0,0,0,0,0,0,0,0,0,0,0,0,0,1
17,1,0,0,0,0,0,0,0,0,0,0,0,0,0,0,0,0,0,0,0,0,0,0,0,0,0,0,0,0,0,0,1
17,6,2,2,2,2,2,2,2,2,2,2,2,2,2,2,2,2,2,2,2,2,2,2,2,2,2,2,2,2,2,2,5
